************************************************************
*............**************.................****************
*******..****....*****************..*******..***************
*******..********.......***********.********.***************
*.......******...............*****..***.*****.............**
*.......*****************.*********..*.**********.........**
*******.******************.*******.**********************..*
*****.....**************...........*****..*********........*
*****..*******************............**********...........*
*........*********************.**********************......*
*..*...**********************.**********.............*******
*.*****.......****************...............*****.*.*******
*...********..........************.****************.********
*.********.***............*******....*************.*********
*............*********************..**.*********...*********
**...*******.********************................*..********
***..******.....*****************.****..******...........***
****..........***........*******..*****..***.....*...*.....*
*......********************............***...*.............*
************************************************************