************************************************************
*............**************.................*****....*******
*******..****....*************.***..*******..*******...*****
*******..********.......******.****.********.********..*****
*.......******............................................**
*.......*****************.*********..*.**********.........**
*..****.******************.*******.********...........***..*
**.**.....****........**...........*****..*********........*
**.**..*******************............**********...........*
*........*********************.**********************......*
*..*...**********************.**********.............*******
*.*****.......****************...............*****.*.*******
*...********..........************.****************.********
*.********.***............*******....*************.*********
*............****..........*******..**.*********...*********
**...*******.********...........*................*..********
***..******.....****.......******.****..******...........***
****.***......***........*******..*****..*************.....*
*......********************............***...*.............*
************************************************************
